1111111111111111111111111111111111
1E4444444444444C44444C444444444441
1414414144144444141441444444414141
1414414414141414441441444444414141
1P4444444C44C4444444444444444444C1
1111111111111111111111111111111111
